{
  "variant": "color1",
  "cols": 8,
  "rows": 8,
  "layers": {
    "water": [
      "11111111",
      "11111111",
      "11111111",
      "11111111",
      "11111111",
      "11111111",
      "11111111",
      "11111111"
    ],
    "ground": [
      "01111000",
      "01111100",
      "11111100",
      "11101110",
      "11101110",
      "01111110",
      "00111100",
      "00010000"
    ],
    "cliff_land": [
      "00111000",
      "00111000",
      "00000000",
      "00001000",
      "00000000",
      "00000000",
      "00000000",
      "00000000"
    ],
    "cliff_water": [
      "00000000",
      "00000000",
      "00000000",
      "00000010",
      "00000000",
      "00000000",
      "00000110",
      "00000000"
    ],
    "slopes": [
      "00000000",
      "00000000",
      "00000000",
      "00001000",
      "00000000",
      "00000100",
      "00000000",
      "00000000"
    ]
  }
}

